#######################
#...#.................#
#...#.................#
#...#..........########
#...#.................#
#...#.................#
#.....................#
#.....................#
#.....................#
#.....................#
#.....................#
#.....................#
#.....................#
############..........#
#.....................#
#................#....#
#................#....#
#................#....#
#................#....#
#................#....#
#................#....#
#######################