#######################
####...............####
##...................##
##...................##
#.....#.........#.....#
#.....#.........#.....#
#.....#.........#.....#
#.....#.........#.....#
#.....#.........#.....#
#.....#.........#.....#
#.....#.........#.....#
#.....#.........#.....#
#.....#.........#.....#
#.....#.........#.....#
#.....#.........#.....#
#.....#.........#.....#
#.....#.........#.....#
#.....#.........#.....#
##...................##
##...................##
####...............####
#######################
